1STこん	1st魂	固有名詞	デビュー&1stコンサート
1stこん	1st魂	固有名詞	デビュー&1stコンサート
2020かむおんとぅーとーきょー	2020 Come on to Tokyo	固有名詞	｢King & Queen & Joker｣B面曲
2020かもんとぅとーきょー	2020 Come on to Tokyo	固有名詞	｢King & Queen & Joker｣B面曲
2し	2誌	名詞	｢Myojo｣｢ポポロ｣のこと
4しーずんず	4 Seasons	固有名詞	
7うぇすと	7WEST	人名	
DJだいき	DJ DAIKI	人名	有岡大貴
Dし	d誌	固有名詞	duet
FC	FC	名詞	
IWGP	IWGP	固有名詞	池袋ウエストゲートパーク
JE	JE	組織	ジャニーズエンターテイメント
Jすとーむ	JStorm	組織	レコード会社
KQJ	KQJ	固有名詞	King & Queen & Joker
Myojo	Myojo	固有名詞	
Mし	M誌	固有名詞	Myojo
Mすて	Mステ	固有名詞	ミュージックステーション
QRぞーん	Qrzone	固有名詞	
UMP	UMP	固有名詞	Ultra Music Power
WinkUp	Wink Up	固有名詞	
Winkup	Wink Up	固有名詞	
Wし	W誌	固有名詞	Wink Up
djだいき	DJ DAIKI	人名	有岡大貴
dし	d誌	固有名詞	duet
fc	FC	名詞	
iwgp	IWGP	固有名詞	池袋ウエストゲートパーク
je	JE	組織	ジャニーズエンターテイメント
jすとーむ	JStorm	組織	
kqj	KQJ	固有名詞	King & Queen & Joker
mし	M誌	固有名詞	Myojo
mすて	Mステ	固有名詞	ミュージックステーション
qrぞーん	Qrzone	固有名詞	
ump	UMP	固有名詞	Ultra Music Power
wし	W誌	固有名詞	Wink Up
あいえぬじーしんこうけい	☆☆I★N★G★進行形	組織	
あいおいたい	愛追I隊	人名	
あいしーざらいとぼくらのすてーじ	I see the light〜僕たちのステージ〜	固有名詞	｢Sexy Zone｣B面曲
あいしてる	愛ing	感動詞	
あいしてる	愛ing -アイシテル-	固有名詞	｢OVER｣B面曲
あいすくりーむ	アイ☆スクリーム	固有名詞	Hey!Say!JUMP 1stアルバム楽曲
あいすればもっとはっぴーらいふ	愛すればもっとハッピーライフ	固有名詞	Hey!Say!JUMP 12thシングル Tr.2
あいのありおか	AinoArioka	固有名詞	AinoArika の誤り
あいのありか	AinoArika	固有名詞	Hey!Say!JUMP 12thシングル
あいのかたまり	愛のかたまり	固有名詞	Kinki Kids
あいのしゅびどぅば	愛のシュビドゥバ	固有名詞	Hey!Say!JUMP 5thアルバム楽曲
あいばちゃん	相葉ちゃん	人名	
あいばまさき	相葉雅紀	人名	
あいぼく	あいぼく	固有名詞	愛よ､僕を導いてゆけ
あいよぼくをみちびいてゆけ	愛よ､僕を導いてゆけ	固有名詞	Hey!Say!JUMP 4thアルバム楽曲
あいるびーぜあ	I'll be there	固有名詞	
あおいきせつ	蒼い季節	固有名詞	
あおふうとう	青封筒	名詞	
あかさかあきら	赤坂晃	人名	
あかにしじん	赤西仁	人名	
あがーるまいふれんど	A MY GIRL FRIEND	固有名詞	｢バィバィDuバィ｣B面曲
あきはれぼくにかぜがふいた	秋､晴れ。僕に風が吹いた。	固有名詞	｢キミアトラクション｣B面曲
あきやまたいが	秋山大河	人名	
あくまなこい	悪魔な恋	固有名詞	
あくろばてぃっく	ACROBATIC	名詞	Snow Manの楽曲
あさんて	Asante	感動詞	スワヒリ語の｢ありがとう｣
あしたにむかってうて	明日に向かって撃て!	固有名詞	｢男 never give up｣B面曲
あしたはれるや	明日ハレルヤ	固有名詞	｢Give Me Love｣B面曲
あじあのよる	アジアの夜	固有名詞	
あすたりすく	Asterisk	固有名詞	
あすのきおく	明日の記憶	固有名詞	
あすへのえーる	明日へのYELL	固有名詞	Hey!Say!JUMP 13thシングル Tr.2
あべあらん	阿部顕嵐	人名	
あべりょうへい	阿部亮平	人名	
あまがさ	雨傘	固有名詞	
あまくさりゅう	天草流	固有名詞	探偵学園Q
あめいじんぐ	Amazing!!!!!!	固有名詞	SixTONESの楽曲
あめだって	雨だって	固有名詞	｢Sexy Summerに雪が降る｣B面曲
あらし	A･RA･SHI	固有名詞	嵐 1stシングル
あらしぐみ	嵐組	組織	
ありおかだいき	有岡大貴	人名	
ありがとう	1992*4##111	感動詞	ニノのソロ曲
ありがとうせかいのどこにいても	｢ありがとう｣ ～世界のどこにいても～	固有名詞	Hey!Say!JUMP 6thシングル
あわでいず	Our days	固有名詞	｢OVER THE TOP｣B面曲
あわふゅーちゃー	OUR FUTURE	固有名詞	｢AinoArika｣B面曲
あんぷ	UMP	固有名詞	Ultra Music Power
いっつごーいんぐだうん	It's going down	固有名詞	｢男 never give up｣B面曲
いっぴ	イッピ	名詞	一般ピープルのこと
いっぴふくろ	イッピ袋	名詞	担当の切り抜き･写真を貼っている袋
いっぴぶくろ	イッピ袋	名詞	担当の切り抜き･写真を貼っている袋
いーのおっけい	いーのおっ慧	感動詞	伊野尾ちゃんのMIX
いいだきょうへい	飯田恭平	人名	
いいんじゃない	いいんじゃない	固有名詞	Hey!Say!7
いう゛	Eve	固有名詞	｢真剣SUNSHINE｣B面曲
いえす	Yes!	固有名詞	怪盗y-ELLOW-voice / Hey!Say!JUMP 3rdアルバム楽曲
いがらしれお	五十嵐玲央	人名	
いがりそうや	猪狩蒼弥	人名	
いくじなし	Ikujinashi	固有名詞	
いぐにっしょん	Ignition	固有名詞	｢キミアトラクション｣B面曲
いしづかともき	石塚知生	人名	作曲･編曲家
いたじゃん	いたジャン	固有名詞	いただきハイジャンプ
いただきはいじゃんぷ	いただきハイジャンプ	固有名詞	
いとしのぷれいがーる	愛しのプレイガール	固有名詞	
いながきごろう	稲垣吾郎	人名	
いなばひかる	稲葉光	人名	
いのおけい	伊野尾慧	人名	
いのはらよしひこ	井ノ原快彦	人名	
いぶ	Eve	固有名詞	｢真剣SUNSHINE｣B面曲
いまいつばさ	今井翼	人名	
いまどきだんしぼうけんばらえてぃまよなかのぷりんす	イマドキ男子冒険バラエティ 真夜中のプリンス	固有名詞	
いやもに	イヤモニ	名詞	イヤーモニター
いわさきたいしょう	岩﨑大昇	人名	
いわはしげんき	岩橋玄樹	人名	
いわもとひかる	岩本照	人名	
いんざすとーむ	IN THE STORM	固有名詞	SixTONESの楽曲
いんびてーしょん	Invitation	名詞	Hey!Say!JUMP 5thアルバム楽曲
いんふぃにてぃ	INFINITY	固有名詞	Hey!Say!JUMP 1stアルバム楽曲
うぃーあーおとこのこ	We are 男の子!	固有名詞	｢真剣SUNSHINE｣B面曲
うぃーくえんだー	ウィークエンダー	固有名詞	Hey!Say!JUMP 13thシングル
うぃずゆー	With you	固有名詞	｢Sexy Zone｣B面曲
うぃんくあっぷ	Wink Up	固有名詞	
うぉーく	Walk	名詞	Hey!Say!JUMP 4thアルバム楽曲
うえくさかつひで	植草克秀	人名	
うえだたつや	上田竜也	人名	
うきしょひだか	浮所飛貴	人名	
うたうたう	ウタウタウ	固有名詞	Hey!Say!JUMP 2ndアルバム楽曲
うちうみこうじ	内海光司	人名	
うちひろき	内博貴	人名	
うめごういんおん	UME強引オン!	固有名詞	
うるとらみゅーじっくぱわー	Ultra Music Power	固有名詞	Hey!Say!JUMP 1stシングル
うるわしのばっとがーる	麗しのBad Girl	固有名詞	
えーびーしーすたーらいん	ABC STAR LINE	固有名詞	
えーびーしーず	A.B.C-Z	組織	
えーびーしーまーけっと	A.B.Sea Market	固有名詞	
えいたー	eighter	組織	
ええじゃないか	ええじゃないか	固有名詞	ジャニーズWESTの楽曲
えたーなる	Eternal	名詞	Hey!Say!JUMP 5thアルバム楽曲 / 赤西仁 1stシングル《同名曲》
えぬわいしー	NYC	組織	
えぬわいしーぼーいず	NYC boys	組織	
えふしー	FC	名詞	
えむえーでぃー	M.A.D.	組織	
えむし	M誌	固有名詞	Myojo
えむすて	Mステ	固有名詞	ミュージックステーション
えんじぇるかむとぅみー	Angel come to me	固有名詞	
えんどれすしょっく	Endless SHOCK	固有名詞	
えんどれすどりーむ	Endless Dream	固有名詞	Hey!Say!JUMP 2ndアルバム楽曲
おーあいどる	Oh!アイドル!	固有名詞	愛追I隊 / Hey!Say!JUMP 3rdアルバム楽曲
おーあいにーぢゅー	我 I Need You	固有名詞	Hey!Say!JUMP 14thシングル Tr.2
おーあいにーどゆー	我 I Need You	固有名詞	Hey!Say!JUMP 14thシングル Tr.2
おーだー	order	名詞	Hey!Say!JUMP 5thアルバム楽曲
おーばー	OVER	名詞形動	Hey!Say!JUMP 7thシングル
おーばーざとっぷ	OVER THE TOP	固有名詞	Hey!Say!JUMP 19thシングル
おーまいじぇりーぼくらはおーけー	Oh! My Jelly! 〜僕らはOK〜	固有名詞	｢AinoArika｣B面曲
おーらす	オーラス	名詞	all last
おーらす	オーラス	名詞形動	all last
おおくらただよし	大倉忠義	人名	
おおさわみきお	大沢樹生	人名	
おおにしりゅうせい	大西流星	人名	
おおのさとし	大野智	人名	
おかだじゅんいち	岡田准一	人名	
おかもとけいと	岡本圭人	人名	
おとこねばーぎぶあっぷ	男 never give up	固有名詞	Sexy Zone 7thシングル
おとこねばぎば	男 never give up	固有名詞	Sexy Zone 7thシングル
おなじそらのした	おなじ空の下	固有名詞	｢バィバィDuバィ｣B面曲
おぶりがーど	Obbligato	感動詞	ポルトガル語の｢ありがとう｣の男性言葉
おれあし	俺足	組織	Kis-My-Ft. / Kis-My-Ft2
おれあしぞく	俺足族	組織	Kis-My-Ft. / Kis-My-Ft2 ファン総称
おれたちのせいしゅん	俺たちの青春	固有名詞	｢Dreams come true｣B面曲
かいし	ガイシ	地名	名古屋･ガイシホール
かいとういえろーぼいす	怪盗y-ELLOW-voice	人名	
かがやきでいず	輝きデイズ	固有名詞	｢瞳のスクリーン｣B面曲
かくしなきろうごく	格子無き牢獄	固有名詞	
かけもち	掛け持ち	名詞	
かじやまあさひ	梶山朝日	人名	
かぜをきって	風をきって	固有名詞	｢Lady ダイヤモンド｣B面曲
かぜかおる	KAZEKAORU	固有名詞	
かつん	勝運	組織	KAT-TUN
かとぅーんらいぶかいぞくばん	KAT-TUN Live 海賊帆	固有名詞	
かとうしげあき	加藤シゲアキ	人名	
かとりしんご	香取慎吾	人名	
かみて	上手	名詞	客席から見て右側のステージ
かみやまともひろ	神山智洋	人名	
かむおん	Cảm on	感動詞	ベトナム語の｢ありがとう｣
かむおんあまいはうす	Come On A My House	固有名詞	Hey!Say!JUMP 10thシングル
かむばっく	Come Back…?	固有名詞	Hey!Say!JUMP 3rdアルバム楽曲
かめなしかずや	亀梨和也	人名	
かめんぶどうかい	仮面舞踏会	固有名詞	
かもな	カモナ	固有名詞	Come On A My House
かもなまいはうす	Come On A My House	固有名詞	Hey!Say!JUMP 10thシングル
かわいふみと	河合郁人	人名	
かわしまのえる	川島如恵留	人名	
かんさいじゃにーずじゅにあ	関西ジャニーズJr.	組織	
かんしゃかんげきあめあらし	感謝カンゲキ雨嵐	固有名詞	
かんじゃに	関ジャニ	組織	
かんじゃにえいと	関ジャニ∞	組織	
かんじゃにえいとのじゃにべん	関ジャニ∞のジャニ勉	固有名詞	
かんじゅ	関ジュ	組織	関西ジャニーズJr.
かんじゅに	関Jr.	組織	関西ジャニーズJr.
かんじるままにゆーあんどあい	感じるままにYou & I	固有名詞	
がっつ	GUTS!	固有名詞	
がんばれっつごー	ガンバレッツゴー!	感動詞	Hey!Say!JUMP 1stアルバム楽曲
きゃんでぃーきゃんゆーびーまいべいびー	CANDY〜Can U be my BABY〜	固有名詞	｢バィバィDuバィ｣B面曲
きゃんどる	Candle	名詞	Hey!Say!JUMP 3rdアルバム楽曲
きゅーあーるぞーん	Qrzone	固有名詞	
きゅうきょくばとるぜうす	究極バトル“ゼウス”	固有名詞	
きょうせら	京セラ	地名	京セラドーム大阪 / または､電子機器会社
きょうもとたいが	京本大我	人名	
きょひたん	拒否担	名詞	
きーぷうぉーきんぐ	KEEP WALKING	固有名詞	
きーぷざちゃれんじ	Keep The Challenge	固有名詞	｢男 never give up｣B面曲
きくちふうま	菊池風磨	人名	
きしゆうた	岸優太	人名	
きすだいありー	KISS Diary	固有名詞	Hey!Say!JUMP 5thアルバム楽曲
きすまい	キスマイ	組織	Kis-My-Ft2
きすまいふっとつー	Kis-My-Ft2	組織	
きたやまひろみつ	北山宏光	人名	
きてぃーじむ	Kitty GYM	組織	
きみあと	きみあと	固有名詞	キミアトラクション
きみあとらくしょん	キミアトラクション	固有名詞	Hey!Say!JUMP 15thシングル
きみとみるきーうぇい	君と…Milky Way	固有名詞	
きみにひとめぼれ	君にHITOMEBORE	固有名詞	Sexy Zone 8thシングル
きみのためぼくがいる	キミのため ボクがいる	固有名詞	｢Sexy Summerに雪が降る｣B面曲
きみのつみだけまぼろしでもかまわない	君の罠だけ幻でも構わない	固有名詞	
きみはないてつよくなる	キミは泣いてツヨクなる	固有名詞	
きみひと	君米	固有名詞	君にHITOMEBORE (米＝ひとめぼれ)
きみまぼ	きみまぼ	固有名詞	君の罠だけ幻でも構わない
きむらたくや	木村拓哉	人名	
きらきらひかれ	キラキラ光れ	固有名詞	Hey!Say!JUMP 4thアルバム楽曲
きりやまあきと	桐山照史	人名	
きんかん	KinKan	組織	
きんききっず	KinKi Kids	組織	
きんぐあんどくいーんあんどじょーかー	King & Queen & Joker	固有名詞	Sexy Zone 6thシングル
きんだいちしょうねんのじけんぼねお	金田一少年の事件簿N	固有名詞	
ぎゃんぐすたー	Gang-Star	組織	
ぎゃんすた	ギャンスタ	組織	Gang-Star
ぎふと	GIFT	名詞	｢Ride With Me｣B面曲
ぎぶみーらぶ	Give Me Love	固有名詞	Hey!Say!JUMP 18thシングル
ぎみら	ぎみら	固有名詞	Give Me Love
ぎんのせかいにねがいをこめて	銀の世界に願いを込めて	固有名詞	
くえすしょん	Question?	組織	
くさなぎつよし	草彅剛	人名	
くさのひろのり	草野博紀	人名	
くらっぷ	QLAP!	固有名詞	
くらすめいとじぇい	Classmate J	組織	
くりぱ	クリパ	名詞	クリスマスパーティー
ぐらっちぇ	Grazie	感動詞	イタリア語の｢ありがとう｣
ぐらしあす	Gracias	感動詞	スペイン語の｢ありがとう｣
ぐろりあす	Glorious	固有名詞	｢Give Me Love｣B面曲
けいきゅーじぇい	KQJ	固有名詞	King & Queen & Joker
けいけいきてぃー	K.K.Kity	組織	
げっと	GET!!	固有名詞	｢Magic Power｣B面曲
こっぷくんくらっぷ	ขอบคุณครับ	感動詞	タイ語の｢ありがとう｣
こうちゆうご	髙地優吾	人名	
こうはくにひとめぼれ	紅白にHITOMEBORE	固有名詞	｢君にHITOMEBORE｣2014年紅白アレンジ
こくぶんたいち	国分太一	人名	
こしおかゆうき	越岡裕貴	人名	
こたきのぞむ	小瀧望	人名	
こどもけいさつ	コドモ警察	固有名詞	MBS･TBS系列のドラマ
このほしのひかり	この星のHIKARI	固有名詞	SixTONESの楽曲
こまうぉよ	고마워요	感動詞	韓国語の｢ありがとう｣
こやまけいいちろう	小山慶一郎	人名	
ころせんせーしょんず	殺せんせーションズ	固有名詞	
こわれそう	コ･ワ･レ･ソ･ウ	固有名詞	B.A.D.の楽曲
こん	魂	名詞	コンサート
こんどうまさひこ	近藤真彦	地名	
こんにちわんつー	こんにちワン・ツー	感動詞	関ジャニ∞横山が使用した挨拶
こんばんぬ	こんばんぬ	感動詞	
こんぱすろーず	コンパスローズ	固有名詞	Hey!Say!JUMP 3rdアルバム楽曲
こんやあなたをくどきます	今夜貴方を口説きます	固有名詞	Hey!Say!JUMP 5thアルバム楽曲
ごー	GO!!!	固有名詞	やぶひかの楽曲
ごーすと	Ghost	固有名詞	Ghost～君は幻～
ごーすときみはまぼろし	Ghost～君は幻～	固有名詞	
ごーとぅーざふゅーちゃー	Go To The Future	固有名詞	｢Ride With Me｣B面曲
ごせきこういち	五関晃一	人名	
ごだぶりゅーいちえいち	5W1H	固有名詞	ジャニーズWEST
さいご	3月15日	名詞	最初(3月14日)と対
さいしょ	3月14日	名詞	3月14日～時計
さいしょのとけい	3月14日～時計	固有名詞	Hey!Say!JUMP 4thアルバム楽曲
さかもとまさゆき	坂本昌行	人名	
さくしーでぃっど	succeed	固有名詞	
さくまだいすけ	佐久間大介	人名	
さくまりゅうと	作間龍斗	人名	
さくらいしょう	櫻井翔	人名	
さくらさいたよ	桜、咲いたよ	固有名詞	｢AinoArika｣B面曲
さくらさくからー	桜咲くColor	固有名詞	
さくらさけ	サクラ咲ケ	固有名詞	
さとうあつひろ	佐藤敦啓	人名	
さとうあつひろ	佐藤アツヒロ	人名	
さとうしょうり	佐藤勝利	人名	
さとうひろゆき	佐藤寛之	人名	
さなだゆうま	真田佑馬	人名	
さまりー	SUMMARY	固有名詞	
さまりーこん	SUMMARY魂	固有名詞	
さむ&ぴんきー	サム & ピンキー	固有名詞	Hey!Say!JUMP 2ndアルバム楽曲
さむあんどぴんきー	サム & ピンキー	固有名詞	Hey!Say!JUMP 2ndアルバム楽曲
さむぴん	サムピン	固有名詞	サム & ピンキー
さらしあい	貶し愛	名詞	
さらまっぽ	Salamat po	感動詞	スペインのタガログ語の｢ありがとう｣
さんきゅーぼくたちからきみへ	Thank You 〜僕たちから君へ〜	固有名詞	Hey!Say!JUMP 1stアルバム楽曲
さんし	3誌	名詞	｢duet｣｢wink up｣｢POTATO｣のこと
さんせん	参戦	名詞サ変	
さんぽうれい	三方礼	名詞サ変	タレントが3方向に礼をすること
さんらいずにっぽん	SUNRISE日本	固有名詞	
ざしょうねんくらぶ	ザ少年倶楽部	固有名詞	
ざしょうねんくらぶぷれみあむ	ザ少年倶楽部プレミアム	固有名詞	
しぇいしぇい	謝謝	感動詞	中国語の｢ありがとう｣
しぇんしぇらしぇん	SHen SHera SHen	固有名詞	Hey!Say!JUMP 4thアルバム楽曲
しゃこん	車魂	固有名詞	JUMPing CARnival
しゃどーうぇすと	Shadow WEST	組織	
しゃどぼ	シャドボ	固有名詞	真夜中のシャドーボーイ
しゃるうぃー	Shall We?	固有名詞	｢キミアトラクション｣B面曲
しゅうじとあきら	修二と彰	人名	
しゅうまつわいわいじゃんぴんぐ	週末YY JUMPing	固有名詞	
しょうくら	少クラ	固有名詞	ザ少年倶楽部
しょうくらぷれみあむ	少クラプレミアム	固有名詞	ザ少年倶楽部プレミアム
しょうねんたい	少年隊	組織	
しあわせのあおいふうとう	幸せの青い封筒	固有名詞	
しげおかだいき	重岡大毅	人名	
しぶたにすばる	渋谷すばる	人名	
しめかけりゅうや	七五三掛龍也	人名	
しもて	下手	名詞	客席から見て左側のステージ
しりつばかれあこうこう	私立バカレア高校	地名	
しんあいこん	親愛魂	固有名詞	DEAR.魂
しんく	真紅	名詞	Hey!Say!JUMP 1stアルバム楽曲
しんぐるめどれーせかんどあくと	シングルメドレー Second act	固有名詞	Hey!Say!JUMP 2ndアルバム楽曲
しんめ	シンメ	名詞形動	シンメトリー(左右対称)
じぇいじぇいえくすぷれす	J.J.Express	固有名詞	
じぇいすとーむ	JStorm	組織	レコード会社
じぇしー	ジェシー	名	
じゃがーず	ジャガーズ	人名	
じゃすといましかない	Justいましかない	固有名詞	
じゃすとふぉーゆー	Just For You	固有名詞	｢Come On A My House｣B面曲
じゃにをた	ジャニヲタ	名詞形動	
じゃにーず・えんたていめんと	ジャニーズ・エンタテイメント	組織	
じゃにーず・えんたていめんと	Johnnys Entertainment	組織	
じゃにーずうぇすともぎたてかんじゅーす	ジャニーズWESTもぎたて関ジュース	固有名詞	
じゃにーずおーるすたーずあいらんど	JOHNNY'S ALL STARS ISLAND	固有名詞	
じゃにーずじゅにあ	ジャニーズJr.	人名	
じゃにーずだいうんどうかい	ジャニーズ大運動会	固有名詞	
じゃにーずふぁいぶ	Johnny's5	組織	
じゃにーずわーるど	JOHNNYS' World -ジャニーズ・ワールド-	固有名詞	
じゃにしょ	ジャニショ	固有名詞	ジャニーズショップ
じゃにすと	ジャニスト	組織	ジャニーズWEST
じゃにたれ	ジャニタレ	名詞形動	
じゃんきゅ	JUMQ	固有名詞	ジャン!ジャン!JUMQ!
じゃんじゃんじゃんきゅ	ジャン! ジャン! JUMQ!	固有名詞	
じゃんぱ	ジャンパ	固有名詞	JUMParty
じゃんぱー	JUMPer	組織	JUMPファン
じゃんぱーてぃー	JUMParty	固有名詞	
じゃんぴんぐかー	JUMPing CAR	固有名詞	Hey!Say!JUMP 4thアルバム
じゃんぴんぐかーにばる	JUMPing CARnival	固有名詞	 
じゃんぴんぐこん	Jump-ing魂	固有名詞	Hey!Say! Jump-ing Tour '08-'09
じゃんぴんぐつあー	Jump-ing Tour	固有名詞	Hey!Say! Jump-ing Tour '08-'09
じゃんぷ	JUMP	固有名詞	Hey!Say!JUMP
じゃんぷあらうんどざわーるど	JUMP Around The World!!!	固有名詞	
じゃんぷこん	JUMP魂	固有名詞	
じゃんぷだべいべー	JUMP da ベイベー!	固有名詞	
じゃんぷなんばーわん	JUMP No.1	固有名詞	Hey!Say!JUMP 1stアルバム
じゃんぷわーるど	JUMP WORLD	固有名詞	Hey!Say!JUMP 2ndアルバム
じゃんぺ	ジャンペ	固有名詞	JUMPaper
じゃんぺーぱー	JUMPaper	固有名詞	
じゅにあ	Jr.	名詞	
じゅにあぼーいず	Jr.BOYS	組織	
じょうしましげる	城島茂	人名	
じょうねつじゃんぷ	情熱JUMP	固有名詞	Hey!Say!JUMP 1stアルバム楽曲
じょうほ	城ホ	地名	大阪城ホール
じぐざぐらぶ	ZIG ZAG LOVE	固有名詞	Snow Manの楽曲
じごろいずむ	ジゴロイズム	固有名詞	
じたばたじゅんじょう	ジタバタ純情	固有名詞	
じたん	自担	名詞	
じんぐうじゆうた	神宮寺勇太	人名	
すーつでいず	スーツデイズ	固有名詞	｢ウィークエンダー｣B面曲
すーぱーすーぱーないと	Super Super Night	固有名詞	ナイトスタイルピーポー / Hey!Say!JUMP 3rdアルバム楽曲
すーぱーでりけーと	SUPER DELICATE	固有名詞	Hey!Say!JUMP 9thシングル
すーぱーまん	SUPERMAN	名詞	Hey!Say!JUMP 5thアルバム楽曲
すいっち	Switch	名詞	
すいきゅうやんきーす	水球ヤンキース	固有名詞	
すきすぎて	スキすぎて	固有名詞	
すぎるせつな	スギルセツナ	固有名詞	｢AinoArika｣B面曲
すくーるかくめい	スクール革命!	固有名詞	テレビ番組
すくーるかくめい	スクール革命	固有名詞	｢真夜中のシャドーボーイ｣B面曲
すくーるがーる	School Girl	固有名詞	｢Ride With Me｣B面曲
すくーるでいず	スクールデイズ	固有名詞	｢Magic Power｣B面曲
すくかく	スク革	固有名詞	スクール革命!
すくらっぷてぃーちゃーきょうしさいせい	スクラップ･ティーチャー〜教師再生〜	固有名詞	
すくらんぶる	スクランブル	固有名詞	｢Come On A My House｣B面曲
すくりゅー	Screw	固有名詞	｢OVER｣B面曲
すくれぼ	スクレボ	固有名詞	スクール革命!
すこあ	Score	名詞	Hey!Say!JUMP 1stアルバム楽曲
すずきだいちひでゆき	鈴木Daichi秀行	固有名詞	作曲･編曲家･ギタリスト
すたーたいむ	Star Time	固有名詞	｢Ultra Music Power｣B面曲
すたーと	START!	固有名詞	Ya-Ya-yahの楽曲
すたんどせき	スタンド席	名詞	アリーナ等以外の傾斜席
すてぃーぶんりー	STEVEN LEE	人名	作曲家
すていごーるど	Stay Gold	固有名詞	
すとーんず	SixTONES	組織	
すなっぷ	スナップ	名詞	Hey!Say!JUMP 2ndアルバム楽曲
すのーあんどすたーず	Snow & Stars	固有名詞	｢君にHITOMEBORE｣B面曲
すのーぷりんすがっしょうだん	スノープリンス合唱団	組織	
すのーまん	Snow Man	組織	
すのうそんぐ	スノウソング	固有名詞	｢｢ありがとう｣ 〜世界のどこにいても〜｣B面曲
すぱいしー	スパイシー	固有名詞	Hey!Say!JUMP 2ndアルバム楽曲
すぱしーば	Спасибо	感動詞	ロシア語の｢ありがとう｣
すぱでり	スパデリ	固有名詞	SUPER DELICATE
すぴーどいっとあっぷ	Speed It Up!	固有名詞	｢真剣SUNSHINE｣B面曲
すぺしゃるらぶ	Special Love	固有名詞	Hey!Say!JUMP 5thアルバム楽曲
すまっぷ	SMAP	組織	
すまーと	smart	固有名詞	Hey!Say!JUMP 3rdアルバム
すまーとこん	smart魂	固有名詞	
すまいるそんぐ	すまいるそんぐ	固有名詞	Hey!Say!JUMP 1stアルバム楽曲
すりる	ス･リ･ル	固有名詞	
するーざないと	Through the night	固有名詞	｢ウィークエンダー｣B面曲
すろーもーしょん	スローモーション	名詞	Hey!Say!JUMP 5thアルバム楽曲
せいしゅんあみーご	青春アミーゴ	固有名詞	
せいじゃくのあさきみといるせかい	静寂の朝､君といる世界。	固有名詞	｢Fantastic Time｣B面曲
せかいこん	世界魂	固有名詞	JUMP WORLD
せくさま	セクサマ	固有名詞	Sexy Summerに雪が降る
せくしーさまーにゆきがふる	Sexy Summerに雪が降る	固有名詞	Sexy Zone 3rdシングル
せくしーぞーん	Sexy Zone	組織	｢Sexy Zone｣グループ名 / 1stシングル
せくしーふぁみりー	Sexy Family	組織	
せくしーぼーいず	Sexy Boyz	組織	
せくしーまつ	Sexy 松	組織	
せくぞ	セクゾ	組織	Sexy Zone
せくぼ	セクボ	組織	Sexy Boyz
せつなさひきかえに	切なさ､ひきかえに	固有名詞	Hey!Say!JUMP 3rdアルバム楽曲
せとり	セトリ	名詞	セットリスト
せぶんうぇすと	7WEST	人名	
せみ	蝉	名詞	劇場版 グラスホッパー
せんがけんと	千賀健永	人名	
せんすて	センステ	名詞	センターステージ
せんせーしょんず	せんせーションズ	固有名詞	→ Hey!Say!JUMP
ぜんすて	全ステ	名詞	全公演参戦
そらぶね	宙船	固有名詞	
たっきー&つばさ	タッキー&翼	組織	
たっきーあんどつばさ	タッキー&翼	組織	
たいむ	Time	固有名詞	Hey!Say!JUMP 1stアルバム楽曲
たかきゆうや	髙木雄也	人名	
たかだしょう	高田翔	人名	
たかはしかいと	高橋海人	人名	
たきざわえんぶじょう	滝沢歌舞伎	固有名詞	
たきざわひであき	滝沢秀明	人名	
たきつば	タキツバ	組織	
たきつば	滝翼	組織	
たぐちじゅんのすけ	田口淳之介	人名	
ただまえへ	ただ前へ	固有名詞	｢ウィークエンダー｣B面曲
たちみ	立ち見	名詞	
たつみゆうだい	辰巳雄大	人名	
たなかこうき	田中聖	人名	
たなかじゅり	田中樹	人名	
たまもりゆうた	玉森裕太	人名	
たんおり	担降り	名詞形動	
たんおり	担降り	名詞サ変	
だっしゅ	Dash!!	固有名詞	Hey!Say!JUMP 1stアルバム楽曲
だーくしすてむこいのおうさまけっていせん	ダークシステム 恋の王座決定戦	固有名詞	TBSテレビドラマ
だいあるあっぷ	Dial Up	固有名詞	NYC boysの楽曲
だぶりゅーし	W誌	固有名詞	Wink Up
だれもしらない	誰も知らない	固有名詞	
だんけしぇーん	Danke schön	感動詞	ドイツ語の｢ありがとう｣
ちゃう	Chau#	終助詞	Hey!Say!JUMP 14thシングル
ちゃちゃちゃちゃんぴおん	Cha-Cha-Cha チャンピオン	固有名詞	
ちゃんすとぅーちぇんじ	Chance to Change	固有名詞	｢Dreams come true｣B面曲
ちくたく	ChikuTaku	固有名詞	｢キミアトラクション｣B面曲
ちねんゆうり	知念侑李	人名	
ちびーず	ちびーず	組織	山田･有岡･知念
つかだりょういち	塚田僚一	人名	
つなぐてとて	つなぐ手と手	固有名詞	Hey!Say!JUMP 2ndアルバム楽曲
てぃーすてぃーゆー	Tasty U	固有名詞	Hey!Say!JUMP 5thアルバム楽曲
ていくあふぁいぶとれいん	Take a "5" Train	固有名詞	
てごしゆうや	手越祐也	人名	
てごます	テゴマス	組織	
てりまかしー	Terima kasih	感動詞	インドネシア語の｢ありがとう｣
てれぽ	テレポ	固有名詞	Teleportation
てれぽーてーしょん	Teleportation	固有名詞	
てれまかしー	Terima kasih	感動詞	インドネシア語の｢ありがとう｣
てんこん	TEN魂	固有名詞	
てんごくこん	天国魂	固有名詞	Hey!Say! サマーコンサート'09 JUMP天国TENGOKU-
てんごくどーむ	TENGOKU DOME	固有名詞	Hey!Say!JUMP TENGOKU DOME 何が起こるかわからない!? 東京ドーム
てんさいしむらどうぶつえん	天才! 志村どうぶつ園	固有名詞	
てんさいじーにあす	天才Genius	組織	
てんじゃんぷ	TEN JUMP	固有名詞	Hey!Say!2010 TEN JUMP
でぃーし	d誌	固有名詞	duet
でぃーじぇいだいき	DJ DAIKI	人名	有岡大貴
でぃーぷないときみおもう	Deep night 君想う	固有名詞	｢真夜中のシャドーボーイ｣B面曲
でぃあー	DEAR.	固有名詞	Hey!Say!JUMP 5thアルバム
でぃあー	Dear.	固有名詞	Hey!Say!JUMP 5thアルバム楽曲
でぃあーこん	DEAR.魂	固有名詞	
でぃすこじょっきー	DISCO JOCKEY!!	固有名詞	Hey!Say!JUMP 4thアルバム楽曲
でんじゃらす	Dangerous	名詞	Hey!Say!JUMP 4thアルバム楽曲
とぅーしゃい	Too Shy	固有名詞	｢Ultra Music Power｣B面曲
とぅげざーふぉーえばー	Together Forever	固有名詞	Hey!Say!JUMP 2ndアルバム楽曲
とぅるーす	truth	固有名詞	
とい	TOY	固有名詞	｢Give Me Love｣B面曲
ときお	TOKIO	組織	
とくべつ	1992*4##111	固有名詞	ニノのソロ曲
とつかしょうた	戸塚祥太	人名	
とつぜんてぃーちゃーきゅー	突然ティーチャーQ!	固有名詞	
とびっこ	とびっ子	組織	
とみおかけんと	冨岡健翔	人名	
とみたまお	冨田真央	人名	
ともだちだよ	ともだちだよ	固有名詞	Hey!Say!JUMP 3rdアルバム楽曲
とらびすじゃぱん	Travis Japan	組織	
とらふぃっくじゃむ	Traffic Jam	固有名詞	｢Give Me Love｣B面曲
とろふぃー	Trophy	固有名詞	｢君にHITOMEBORE｣B面曲
どぅばい	Doバイ	固有名詞	バィバィDuバィ～See you again～
どぅばい	Duバィ	固有名詞	バィバィDuバィ〜See you again〜
どうたん	同担	名詞	
どうもとこういち	堂本光一	人名	
どうもとつよし	堂本剛	人名	
どりーまー	DREAMER	固有名詞	Hey!Say!JUMP 1stアルバム楽曲
どりーむずかむとぅるー	Dreams come true	固有名詞	Hey!Say!JUMP 2ndシングル
どりーむますたー	ドリームマスター	固有名詞	Hey!Say!JUMP 5thアルバム楽曲
どりかむ	ドリカム	固有名詞	Dreams come true
どるし	ドル誌	名詞	アイドル雑誌
ないとすたいるぴーぽー	ナイトスタイルピーポー	人名	
なうぇすと	なうぇすと	固有名詞	ジャニーズWEST 3rdアルバム
なかいまさひろ	中居正広	人名	
なかじまけんと	中島健人	人名	
なかじまゆうと	中島裕翔	人名	
なかだひろき	仲田拡輝	人名	
なかまじゅんた	中間淳太	人名	
なかまるゆういち	中丸雄一	人名	
なかむらかいと	中村海人	人名	
なかやまゆうま	中山優馬	人名	
なかやまゆうまうぃずびーあいしゃどー	中山優馬 w/B.I.Shadow	組織	
ながせともや	長瀬智也	人名	
ながせれん	永瀬廉	人名	
ながつまれお	長妻怜央	人名	
ながのひろし	長野博	人名	
なつやすみじゃにーずじゅにあぜんいんしゅうごう	夏休み ジャニーズJr. 全員集合	固有名詞	
にゅーえいじ	NEW AGE	固有名詞	｢キミアトラクション｣B面曲
にゅーす	NEWS	組織	
にゅーほーぷこんなにぼくらはひとつ	New Hope 〜こんなに僕らはひとつ	固有名詞	｢Come On A My House｣B面曲
にっぽんちゃちゃちゃちゃんぴおん	ニッポン Cha-Cha-Cha チャンピオン	固有名詞	｢Cha-Cha-Cha チャンピオン｣2015年紅白アレンジ
にかいどうたかし	二階堂高嗣	人名	
にし	2誌	名詞	｢Myojo｣｢ポポロ｣のこと
にしきおりかずきよ	錦織一清	人名	
にしきどりょう	錦戸亮	人名	
にしはただいご	西畑大吾	人名	
にのみやかずなり	二宮和也	人名	
ぬるふふふ	ﾇﾙﾌﾌﾌ	感動詞	殺せんせーの口癖
ねくすて	ねくすて	固有名詞	NEXT STAGE
ねばーれっとぅーごー	Never Let You Go	固有名詞	｢Fantastic Time｣B面曲
ねばーれっとゆーごー	Never Let You Go	固有名詞	｢Fantastic Time｣B面曲
ねばぎば	ねばぎば	固有名詞	男 never give up
ねむりのもり	眠リノ森	固有名詞	｢Magic Power｣B面曲
のっくのっくのっく	Knock! Knock!! Knock!!!	固有名詞	｢Sexy Zone｣B面曲
のいじーがいず	Noisy Guys	組織	
のうなんだんす	脳内☆Dance	固有名詞	
のざわゆうき	野澤祐樹	人名	
はっぴーはっぴーらっきーゆー	Happy Happy Lucky You!!	固有名詞	
はいじゃんぷ	ハイジャンプ	固有名詞	いただきハイジャンプ
はいはいじぇっと	HiHi Jet	組織	
はいはいじぇっと	Hi Hi JET	固有名詞	HiHi Jetの楽曲
はいはいじぇっととぅーざむーん	HI HI JET TO THE MOON	固有名詞	HiHi Jetの楽曲
はいはいぴーぷる	High!! High!! People	固有名詞	｢Lady ダイヤモンド｣B面曲
はいへいせい	Hi! Hey! Say!	固有名詞	
はぎやけいご	萩谷慧悟	人名	
はしもとりょうすけ	橋本良亮	人名	
はじまりのめろでぃ	はじまりのメロディ	固有名詞	Hey!Say!JUMP 3rdアルバム楽曲
はちどり	Hachidori	固有名詞	｢男 never give up｣B面曲
はなえがお	花 えがお	固有名詞	Hey!Say!JUMP 2ndアルバム楽曲
はばゆうき	羽場友紀	人名	
はぴらき	はぴらき	固有名詞	Happy Happy Lucky You!!
はまだたかひろ	濵田崇裕	人名	
はまなかぶんいち	浜中文一	人名	
はりーあっぷ	Hurry up!	固有名詞	Hey!Say!JUMP 2ndアルバム楽曲
はるこん	春魂	名詞	Spring Concert
はるなつあきふゆ	HA･RU･NA･TSU･A･KI･FU･YU	固有名詞	Ya-Ya-yah
はんずあっぷ	Hands Up	固有名詞	｢Ride With Me｣B面曲
ばっくぼーん	BACKBORN	固有名詞	
ばっと	B.A.D.	人名	
ばっとぼーいず	BAD BOYS	固有名詞	Sexy Zone 4thシングル Tr.2
ばっとぼーいずじぇい	BAD BOYS J	固有名詞	日テレ系列のドラマ
ばいばいどぅばい	バィバィDuバィ	固有名詞	Sexy Zone 5thシングル
ばいばいどぅばいしーゆーあげいん	バィバィDuバィ〜See you again〜	固有名詞	Sexy Zone 5thシングル
ばうんす	BOUNCE	固有名詞	｢Come On A My House｣B面曲
ばうんすばっく	BOUNCEBACK	人名	作曲･編曲家
ばくしょうひゃっぷんてれびへいせいふぁみりーず	爆笑100分テレビ!平成ファミリーズ	固有名詞	
ばくすて	バクステ	名詞	
ばにらあいす	Vanilla Ice	固有名詞	｢OVER THE TOP｣B面曲
ばんきょう	番協	名詞	
ばんせん	番宣	名詞	
ぱーてぃー	PARTY!!	固有名詞	｢OVER THE TOP｣B面曲
ぱーふぇくとらいふ	パーフェクト ライフ	固有名詞	Hey!Say!JUMP 2ndアルバム楽曲
ぱーりーもんすたー	パーリーモンスター	固有名詞	｢真剣SUNSHINE｣B面曲
ぱすてる	パステル	名詞	Hey!Say!JUMP 3rdアルバム楽曲
ぱぴーぶー	Puppy Boo	固有名詞	Hey!Say!JUMP 4thアルバム楽曲
ぱわーおぶらん	Power of Run	固有名詞	｢King & Queen & Joker｣B面曲
ひゃくしきおう	百識王	固有名詞	
ひっぷほっぷじゃんぷ	Hip Hop JUMP	組織	
ひーろー	Hero	固有名詞	Hey!Say!JUMP 2ndアルバム楽曲
ひかるげんじ	光GENJI	組織	
ひがしやまのりぬき	東山紀之	人名	
ひだりめたんていあい	左目探偵EYE	固有名詞	
ひとみのすくりーん	瞳のスクリーン	固有名詞	Hey!Say!JUMP 5thシングル
ひらのしょう	平野紫耀	人名	
ひるなんです	ヒルナンデス!	固有名詞	
びっくげーむ	BIG GAME	固有名詞	
びっぐぎゃんぐす	Big Gangs	組織	
びーあい	B.I.	人名	B.I.Shadow
びーあいしゃどう	B.I.Shadow	人名	
びーあらいぶ	BE ALIVE	固有名詞	｢Magic Power｣B面曲
びーくれいじー	BE CRAZY	固有名詞	SixTONESの楽曲
びーとらいん	Beat Line	固有名詞	｢Magic Power｣B面曲
びくげ	びくげ	固有名詞	BIG GAME
びたーすいーと	Bittersweet	固有名詞	
びとら	びとら	固有名詞	Beat Line
びばない	びばない	固有名詞	Viva! 9's SOUL
びばないんずそうる	Viva! 9's SOUL	固有名詞	Hey!Say!JUMP 4thアルバム楽曲
びりびりだんす	ビリビリDANCE	固有名詞	
ぴかんち	PIKA☆NCHI	固有名詞	
ぴかんちだぶる	PIKA☆☆NCHI DOUBLE	固有名詞	
ふぁーすとこん	1st魂	固有名詞	デビュー&1stコンサート
ふぁいぶばいてん	5×10	固有名詞	嵐
ふぁみくら	ファミクラ	名詞	
ふぁんきーたいむ	Funky Time	固有名詞	｢OVER THE TOP｣B面曲
ふぁんたしすと	Fantasist	固有名詞	Hey!Say!JUMP 4thアルバム楽曲
ふぁんたすてぃっくたいむ	Fantastic Time	固有名詞	Hey!Say!JUMP 17thシングル
ふぃーばー	Fever	名詞	Hey!Say!JUMP 4thアルバム楽曲
ふぇあうぇー	Farewell	固有名詞	Hey!Say!JUMP 4thアルバム楽曲
ふぇいく	FaKe	固有名詞	｢バィバィDuバィ｣B面曲
ふぉ~ゆ~	ふぉ〜ゆ〜	組織	
ふぉーえばー	FOREVER	名詞	Hey!Say!JUMP 3rdアルバム楽曲
ふぉーしーずんず	4 Seasons	固有名詞	
ふぉーゆー	ふぉ〜ゆ〜	組織	
ふかざわたつや	深澤辰哉	人名	
ふくしのぶき	福士申樹	人名	
ふくたん	副担	名詞	
ふくだゆうた	福田悠太	人名	
ふじいりゅうせい	藤井流星	人名	
ふじがやたいすけ	藤ヶ谷太輔	人名	
ふたりがけのばしょ	二人掛けの場所	固有名詞	｢｢ありがとう｣ 〜世界のどこにいても〜｣B面曲
ふゆこん	冬魂	名詞	Winter Concert
ふらい	FLY	名詞	｢｢ありがとう｣ 〜世界のどこにいても〜｣B面曲
ふるかぶ	古株	名詞	
ふろむ	From.	固有名詞	Hey!Say!JUMP 5thアルバム楽曲
ふろむえーびーしーとぅーじー	from ABC to Z	固有名詞	
ぶいしっくす	V6	組織	
ぶさいく	舞祭組	組織	
ぶらっくあんどほわいと	Black & White	固有名詞	Kis-My-Ft2の楽曲
ぶらほわ	ブワホラ	固有名詞	Black & White
ぶらんどにゅーわーるど	Brand New World	固有名詞	Hey!Say!JUMP 5thアルバム楽曲
ぷれぞん	プレゾン	名詞	PLAY ZONE
ぷれぞん	PLAYZONE	固有名詞	
ぷれちゅーどおぶすまーと	～Prelude of smart～	固有名詞	Hey!Say!JUMP 3rdアルバム楽曲
へいせい	Hey!Say!	固有名詞	Hey!Say!7のデビュー曲
へいせい2010てんじゃんぷ	Hey!Say! 2010 TEN JUMP	固有名詞	
へいせいさまーこんさーとぜろきゅうじゃんぷてんごく	Hey!Say! サマーコンサート'09 JUMP天国TENGOKU-	固有名詞	
へいせいじゃんぴんぐつあー	Hey!Say! Jump-ing Tour '08-'09	固有名詞	
へいせいじゃんぷ	Hey!Say!JUMP	組織	 
へいせいじゃんぷうぃんたーこんさーと	Hey!Say!JUMP WINTER CONCERT 09-10	固有名詞	
へいせいじゃんぷこんさーとつあー09はる	Hey!Say!JUMP CONCERT TOUR '09春	固有名詞	
へいせいじゃんぷこんさーとつあーぜろきゅうはる	Hey!Say!JUMP CONCERT TOUR '09春	固有名詞	
へいせいじゃんぷてんごくどーむ	Hey!Say!JUMP TENGOKU DOME 何が起こるかわからない!? 東京ドーム	固有名詞	
へいせいせぶん	Hey!Say!7	組織	 
へいせいせぶんうぇすと	Hey!Say!7 WEST	人名	
へいせいせぶんうるとらぱわー	Hey!Say!7 Ultra Power	固有名詞	ラジオ番組
へいせいせぶんすぷりんぐこんさーとぜろきゅーもんきー	Hey!Say!7 spring concert 09 MONKEY	固有名詞	
へいせいせぶんすぷりんふこんさーと09もんきー	Hey!Say!7 spring concert 09 MONKEY	固有名詞	
へいせいにせんじゅうてんじゃんぷ	Hey!Say! 2010 TEN JUMP	固有名詞	
へいせいふぁみりーず	平成ファミリーズ	固有名詞	日テレの番組
へいせいべすと	Hey!Say!BEST	組織	 
べいさいどえれじー	ベイサイドエレジー	固有名詞	｢Sexy Summerに雪が降る｣B面曲
べいびー	B.A.B.Y.	固有名詞	Hey!Say!JUMP 5thアルバム楽曲
べいびーあいらびゅー	Baby I Love You	固有名詞	｢Give Me Love｣B面曲
べいびーあいらぶゆー	Baby I Love You	固有名詞	｢Give Me Love｣B面曲
べてらん	Veteran	組織	
べりーべりーはっぴー	Very Very Happy	固有名詞	Hey!Say!JUMP 4thアルバム楽曲
ぺっとしょっぷらぶもーしょん	ペットショップラブモーション	固有名詞	
ぺとら	ペトラ	固有名詞	ﾍﾟｯﾄｼｮｯﾌﾟﾗﾌﾞﾓｰｼｮﾝ
ぺんら	ペンラ	名詞	
ほんじつみじゅくもの	本日､未熟者	固有名詞	
ぼーいずどんとすとっぷ	Boys Don't Stop	固有名詞	Hey!Say!JUMP 4thアルバム楽曲
ぼーんいんじあーす	Born in the EARTH	固有名詞	｢OVER｣B面曲
ぼうけんらいだー	冒険ライダー	固有名詞	｢Your Seed｣B面曲
ぼくとけいと	僕とけいと	固有名詞	Hey!Say!JUMP 5thアルバム楽曲
ぼくはきみのすべてになりたい	僕は君のすべてになりたい	固有名詞	｢男 never give up｣B面曲
ぼくはばんぱいあ	僕はVampire	固有名詞	Hey!Say!JUMP 2ndアルバム楽曲
ぼんあす	ボンアス	固有名詞	Born in the EARTH
ぽし	ポ誌	名詞	ポポロ
まったなんてなし	待ったなんてなしっ!	固有名詞	｢King & Queen & Joker｣B面曲
まあさや	ma-saya	名	作詞家
まいがーる	My Girl	固有名詞	Hey!Say!JUMP 5thアルバム楽曲
まいじゃに	まいジャニ	固有名詞	まいど!ジャーニィ〜
まいどじゃーにぃー	まいど!ジャーニィ〜	固有名詞	
まいわーるど	My World	固有名詞	Hey!Say!JUMP 3rdアルバム楽曲
まかいのこうじ	馬飼野康二	人名	作詞･作曲家
まぐねてぃっく	Magnetic	名詞	B.A.D.の楽曲
まけへんでべいびー	負けへんで Baby	固有名詞	
まじっくぱわー	Magic Power	固有名詞	Hey!Say!JUMP 8thシングル
まじさんしゃいん	真剣SUNSHINE	固有名詞	Hey!Say!JUMP 16thシングル
まじぱ	まじぱ	固有名詞	Magic Power
ますかれーど	Masquerade	固有名詞	Hey!Say!JUMP 5thアルバム楽曲
ますだたかひさ	増田貴久	人名	
まつおかまさひろ	松岡昌宏	人名	
まつくらかいと	松倉海斗	人名	
まつざきゆうすけ	松崎祐介	人名	
まつしまそう	松島聡	人名	
まつじゅん	松潤	人名	
まつむらほくと	松村北斗	人名	
まつもとじゅん	松本潤	人名	
まよなかのしゃどーぼーい	真夜中のシャドーボーイ	固有名詞	Hey!Say!JUMP 4thシングル
まりうすよう	マリウス葉	人名	
まるやまりゅうへい	丸山隆平	人名	
みょうじょう	Myojo	固有名詞	
みす・すのーまん	Mis Snow Man	組織	
みすう゛ぁ	ミスヴァ	固有名詞	ミステリー ヴァージン
みすすのーまん	Mis Snow Man	組織	
みすたーきんぐぶいえすみすたーぷりんす	Mr.King vs Mr.Prince	組織	
みすたーふろーれす	Mr.Flawless	固有名詞	Hey!Say!JUMP 5thアルバム楽曲
みすてりーう゛ぁーじん	ミステリー ヴァージン	固有名詞	
みすてりーばーじん	ミステリー ヴァージン	固有名詞	
みちえだしゅんすけ	道枝駿佑	人名	
みやけけん	三宅健	人名	
みやたとしや	宮田俊哉	人名	
みやだてりゅうた	宮舘涼太	人名	
みやだてりょうた	宮舘涼太	人名	
みやちかかいと	宮近海斗	人名	
みんと	mint	組織	
むーんらいと	Moonlight	名詞	山田涼介
むーんらいとうぉーかー	Moonlight walker	固有名詞	
むかいこうじ	向井康二	人名	
むたしゃっきる	مُتَشَكِّر	感動詞	アラビア語の｢ありがとう｣
むたしゃっきる	Mu tashàkkir	感動詞	アラビア語の｢ありがとう｣ ｱﾙﾌｧﾍﾞｯﾄ表記
むらかみしんご	村上信五	人名	
むろりゅうた	室龍太	人名	
めいど	MADE	組織	
めもりーず	Memories	名詞	Hey!Say!JUMP 1stアルバム楽曲
めるしー	Merci	感動詞	フランス語の｢ありがとう｣
めるしーぼく	Merci beaucoup	感動詞	フランス語の｢ありがとう｣のvery much相当
めれんげ	メレンゲ	名詞	メレンゲの気持ち
めれんげのきもち	メレンゲの気持ち	固有名詞	
めんすて	メンステ	名詞	メインステージ
もぎたてかんじゅーす	もぎたて関ジュース	固有名詞	
もりうちたかひろ	森内貴寛	人名	
もりたごう	森田剛	人名	
もりたみゅうと	森田美勇人	人名	
もりもとしんたろう	森本慎太郎	人名	
もりもとりゅうたろう	森本龍太郎	人名	
もろほしかずみ	諸星和己	人名	
もろほししょうき	諸星翔希	人名	
やーやーやー	Ya-Ya-yah	名詞	
やあ	夜亜	固有名詞	Ya-Ya-yah
やおとめひかる	八乙女光	人名	
やじるしこん	矢印魂	固有名詞	全国へJUMPツアー2013
やすいけんたろう	安井謙太郎	人名	
やすだしょうた	安田章大	人名	
やぶこうた	薮宏太	人名	
やぶひか	やぶひか	固有名詞	薮宏太･八乙女光
やまぐちたつや	山口達也	人名	
やましたともひさ	山下智久	人名	
やまだりょうすけ	山田涼介	人名	
やまもとじゅんいち	山本淳一	人名	
やまゆと	やまゆと	固有名詞	山田涼介･中島裕翔
やんぐ&びゅーてぃふる	Young & Beautiful !	固有名詞	｢バィバィDuバィ｣B面曲
やんぐあんどびゅーてぃふる	Young & Beautiful !	固有名詞	｢バィバィDuバィ｣B面曲
やんやんじゃんぷ	ヤンヤンJUMP	固有名詞	
ゆー・がった・もーる	ユー･ガッタ･モール	固有名詞	｢OVER｣B面曲
ゆーがったもーる	ユー･ガッタ･モール	固有名詞	｢OVER｣B面曲
ゆーとたたいてみた	ゆーと叩いてみた。	固有名詞	Hey!Say!JUMP 3rdアルバム楽曲
ゆーとびーと	YUTOBEAT	固有名詞	車魂より。drummaniaのパロディ
ゆあしーど	Your Seed	固有名詞	Hey!Say!JUMP 3rdシングル
ゆあしど	ユアシド	固有名詞	Your Seed
ゆうき100%	勇気100%	固有名詞	
ゆうきひゃくぱーせんと	勇気100%	固有名詞	
ゆうとたたいてみた	ゆーと叩いてみた。	固有名詞	
ゆうまうぃずびーあいしゃどう	優馬 w/ B.I.Shadow	人名	
ゆとやま	ゆとやま	固有名詞	中島裕翔･山田涼介
ゆにおん	UNION	名詞	Hey!Say!JUMP 4thアルバム楽曲
ゆめたまご	ユメタマゴ	固有名詞	
ゆめなか	夢中	固有名詞	いたジャンの企画
よこおわたる	横尾渉	人名	
よこやまゆう	横山裕	人名	
よわむししゅーたー	ヨワムシ★シューター	固有名詞	Hey!Say!JUMP 4thアルバム楽曲
らいどうぃずみー	Ride With Me	固有名詞	Hey!Say!JUMP 11thシングル
らじらー	らじらー!	固有名詞	
らじらーさたでー	らじらー! サタデー	固有名詞	
らぶかぜ	LOVE風	固有名詞	｢男 never give up｣B面曲
らぶくりみなる	Love Criminal	名詞	中間淳太の楽曲
らぶそーすうぃーと	Love so sweet	固有名詞	
らぶとぅーん	Love-tune	組織	
らぶふう	LOVE風	固有名詞	｢らぶかぜ｣の誤り
らぶみー	Love meee	固有名詞	小瀧望の楽曲
ららりら	ララリラ	固有名詞	B.I.Shadow
らんだーらんどとれいん	ワンダーランド･トレイン	固有名詞	｢SUPER DELICATE｣B面曲
らんでぶー	RUN de Boo!	固有名詞	Hey!Say!JUMP 5thアルバム楽曲
りっぷす	LIPS	名詞	
りあるせくしー	Real Sexy!	固有名詞	Sexy Zone 4thシングル
りとら	リトラ	固有名詞	リトルトーキョーライブ
りとるとーきょーらいふ	リトルトーキョーライブ	固有名詞	
りぶーと	Reboot!!!	固有名詞	
りろーど	RELOAD	名詞	Hey!Say!JUMP 3rdアルバム楽曲
れいんぼーきゃんでぃーがーる	レインボーキャンディーガール	固有名詞	｢ウィークエンダー｣B面曲
れでぃ・すぱいしー	レディ･スパイシー	固有名詞	｢君にHITOMEBORE｣B面曲
れでぃ・だいやもんど	Lady ダイヤモンド	固有名詞	Sexy Zone 2ndシングル
れでぃーごー	Ready Go	固有名詞	Hey!Say!JUMP 3rdアルバム楽曲
れでぃすぱいしー	レディ･スパイシー	固有名詞	｢君にHITOMEBORE｣B面曲
れでぃだいやもんど	Lady ダイヤモンド	固有名詞	Sexy Zone 2ndシングル
ろみおあんどじゅりえっと	Romeo & Juliet	固有名詞	｢瞳のスクリーン｣B面曲
ろみじゅり	ろみじゅり	固有名詞	Romeo & Juliet
わっつあふぃーりんぐ	What A Feeling	固有名詞	｢Fantastic Time｣B面曲
わっとあふぃーりんぐ	What A Feeling	固有名詞	｢Fantastic Time｣B面曲
わいわい	YY	固有名詞	週末YY JUMPing
わたしのおきて	私のオキテ	固有名詞	チキンバスケッツ
わたなべしょうた	渡辺翔太	人名	
われあいにーどぅー	我 I Need You	固有名詞	
わんだーらんど・とれいん	ワンダーランド･トレイン	固有名詞	｢SUPER DELICATE｣B面曲
わんだーろーど	ワンダーロード	固有名詞	｢Fantastic Time｣B面曲
わんだなむる	Wandanamuru	感動詞	ターミル語の｢ありがとう｣
わんとれ	ワントレ	固有名詞	ワンダーランド･トレイン
わんらぶ	One Love	固有名詞	
